****************
*    *        E*
* *     ********
* ******* *    *
*         *    *
********* *    *
*S             *
****************
